C 					50,50,100
C 					50,50,100
NO  ./textures/eagle.xpm
F 100,50,50


EA ./textures/colorstone.xpm
SO ./textures/redbrick.xpm
WE ./textures/wood.xpm

        1111111111111111111111111
        1000000000110000000000001
        1011000001110000000000001
        1001000000000000000000001
111111111011000001110000000000001
100000000011000001110111110111111
111101111111111111000000100011
111101111111111 111010100100011
110000001101011 111000000100011
100000000000001111000000100011
100000000000000011010100100011
11000001110101011111011110S0111
11110111 1110101 101111010001
11111111 1111111 111111111111
